R 1920 1080
NO ./textures/eagle.xpm
SO ./textures/red.xpm
WE ./textures/purplestone.xpm
EA ./textures/greystone.xpm
S ./textures/linkpixel.xpm
F 255,125,60
C 0,100,255

1111111111111111111111111111111111111111111111111
1N00000000000000000000010000000000000000000000001
1000000000000000000002000000100000200000000000001

1000000000000000000000000000000000000000000000001
1111111111111111111000000000000111111111111111111
                  10000000200001
                  10000010000001
                  11001000001001
                  10000000000201
                  10000000000001
                  10000000000001
                  10000000000101
                  10000010000001
                  10200000000201
                  10000000000001
                  10000000000001
                  10000000000001
                  11111111111111