R 1920 1080
NO ./textures/eagle.xpm
SO ./textures/red.xpm
WE ./textures/purplestone.xpm
EA ./textures/greystone.xpm
S ./textures/linkpixel.xpm
F 125,5,55
C 25,47,0

1111111111111111111111
1020N00000   000000001
1000000000000000000001
1000000111111110000001
10200001      10  0001
10000001      10000001
10002001      10000201
10000001      10000001
100  001      10000201
11111111      11111111