R     1920    1080


NO     ./textures/eagle.xpm


SO         ./textures/red.xpm

WE    ./textures/purplestone.xpm








EA       ./textures/greystone.xpm

S     ./textures/linkpixel.xpm




F 255,5,55





C 25,47,255

1111111111111111111111111111
1 00000000000S0000000000 001
1000000000000200000000000001
1000000001111111111111111111
1000000001        
1011 00001        
1000000001        
100  00001111111111111111111
1000100000000000022000000001
1000000002     2000000000001
1111111111111111111111111111