R     1920      1080



NO            ./textures/fuhrer.xpm


SO      ./textures/red.xpm


WE    ./textures/purplestone.xpm


EA ./textures/greystone.xpm

S  ./textures/linkpixel.xpm




F 125,55,55



C 255,47,0

1111111111111111111111111111
1 0000  00000S0000000000 001
1000000000000200000000000001
1000000001111111111000100001
1000000001        1001010001
1011 00001        1000000001
1000000001        1001000001
1000000001111111111000000001
1000100000000000022000000001
1000000002000002000       01
1111111111111111111111111111