R 1920 1080
NO ./textures/eagle.xpm
SO ./textures/red.xpm
WE ./textures/purplestone.xpm
EA ./textures/greystone.xpm
S ./textures/linkpixel.xpm
F 0,255,255
C 0,255,0

11111111111111111111111111111111111111111111111111111111111111111111111111111111
1020W000000000000000000000000000000000000000000000000000000000000000000000000001
10000000000000000000000000000200000000000000000000000000011     100100000 111111
10000000000000000000000000000000000000000000000002000000000000000000000000000001
10000000000000000000000000000000000000000000000000000000000000000000000000000001
10000000100000000000000000000000000000000000000000000000000000000000000100000001
1000000000000000000000000000000     00000000000000000000000000000000000000000001
10000000000000000000000000000000000000000000000000000200000000000100000000000001
10010000000000200000020000000000000000000000000000000000000000000000000000000001
100000000000100000000000000000000000000000020000000000010000000   00000000000001
10000000000000000000000011111111111111111111111111111111110000000000000000000001
1000000000000000000000001                                10000000000011111111111
1000000000000000000000001                                10000000000000000000001
1000000000000000001100001                                10000000000000000000001
1000000000000000000000001                                10000000000000000000001
1000000200000000000000001                                10000000000000000000001
1000000000000000000000001                                10000000000000000000001
1000000000000000000000001                                10000000010000000000001
1000000000000000000000001                                10000000000000000000001
100000000000 000000000001                                10000000000000000000001
1000000000000000000000001                                10000000000000000000001
1000000000000000000000001                                10000000000100000000001
1000000000000000000000001                                10000000001000000000001
1111111111111111111111111                                11111111111111111111111