R 1920 1080
NO ./textures/eagle.xpm
SO ./textures/red.xpm
WE ./textures/purplestone.xpm
EA ./textures/greystone.xpm
S ./textures/linkpixel.xpm
F 125,5,55
C 25,47,0

1111111111111111111111111111111111111111111111111111111111111111111111111111111111
1020W00000000000000000000000000000000000000000000000000000000000000000000000000001
10000000000000000000000000000200000000000000000000000000011     100100000 11111111
1000000100000001000000000000000000000000000000000200000000000000000000000000000001
1000000000000000002000000000000000000000000000000000000000000000000000000000000001
1000000010000000020000000000000000000000000000000000000000000000000000010000000001
1000000000000110000000000000000     0000000000000000000000000000000000000000000001
1000000000001000000020000000000000000000000000000000020000000000010000000000000001
1001000000000020000002000000000000000000000000000000000000000000000000000000000001
100000000000100000000000000000000000000000020000000000010000000   0000000000000001
1000000000000000000000001111111111111111111111111111111111000000000000000000000001
1000000000100000000000000000000001000000000000000000000000020000000000011111111111
1000000000000000000000000000010000000000000000000000000000000000000000000000000001
1000000010000000001100000000000000000000000000000000000000010000000000000000000001
1000000000000000000000000000000000010000000000000000000000010000000000000000000001
1000000200000000000000002000000000000000000000000000000000010000000000000000000001
1000000000000000001000000200000010000000000000000000000000010000000000000000000001
10000000000000010000000000200000001000000000000000000000000 0000000010000000000001
1000000000000010000000000000002000000000000000000000000000010000000000000000000001
100000000000 000000000101000000000000000000000000000000000010000000000000000000001
1000000000000000000000000000000000000100000000000000000000010000000000000000000001
1000000000000000000000000000000000001000000000000000000000010000000000100000000001
1000000000000000000000000001000000010000000000000000000000010000000000000000000001
1111111111111111111111111111111111111111111111111111111111111111111111111111111111