R          1500    1000


NO       ./textures/eagle.xpm



SO             ./textures/red.xpm


F 0,255,255




WE ./textures/purplestone.xpm



EA ./textures/greystone.xpm


S         ./textures/linkpixel.xpm
C 0,255,0

1111111111111111111111111111111
10001000100000000100S1020000001
1111111110010010101010101001011
1212121221212100000000000001010
1                             1
1111100000000000001001000000011
111111110001000  00 00 00 0  01
110110 00 0 0 00101 00 200 20 1
1 0 0 0 00 0 01210 00 001012111
1000 00  00 0 101 00 0 00 0 001
1    00000020000020200002000021
1  00 0100101010100001010111011
1101100101010102020020202000001
1111000000000000000000000100001
1122200000000200000020020000001
1122200000000200000020020000001
1122200000000200000020020000001
1122200000000200000020020000001
1122200000000200000020020000001
1122200000000200000020020000001
1122200000000200000020020000001
100000000000000111111111111111111111
10000000000000011111111111111111111111111111111111111111111111111111111111111111
10201000000000000000000000000000000000000000000000000000000000000000000000000001
10000000000000000000000000000200000000000000000000000000011     100100000 111111
10000000000000000000000000000000000000000000000002000000000000000000000000000001
10000000000000000000000000000000000000000000000000000000000000000000000000000001
10000000100000000000000000000000000000000000000000000000000000000000000100000001
1000000000000000000000000000000     00000000000000000000000000000000000000000001
10000000000000000000000000000000000000000000000000000200000000000100000000000001
10010000000000200000020000000000000000000000000000000000000000000000000000000001
100000000000100000000000000000000000000000020000000000010000000   00000000000001
11111111111111111111111111111111111111111111111111111111111111111111111111111111