R            1920    1080


NO          ./textures/eagle.xpm






WE    ./textures/purplestone.xpm




SO         ./textures/red.xpm






F 255,5,55







EA                                              ./textures/greystone.xpm

S                                     ./textures/linkpixel.xpm









C 25,47,255

1111111111111111111111111111111111111111
111111111111111111111111111111111111111111111
11111111E00000      000000000       111   111
11111111         2        2         111111111
11111111          11111111          111111111
11111111  00      1 1 1 11          111
11111111          11111111  00      111111111
11111111    00   2        2         1111  111
11111111000000000000000000          111111111
       1    00   1111111111111111111111111111
    1111         111110000000000
11111111    00   1111111
11111111         1111111111
111  111         1111111111111
11111111   2     11111000000000000
11111111         11111111111 00000000000
11  1111         11111111         1111111111111
111111110000     11111111         11111111111
11111111         1111111111111111111111111111
11  11111111111111111111111
111111111111111111111111111111111111111111111