R   1920       1080 



NO   ./textures/eagle.xpm



SO       ./textures/red.xpm


WE         ./textures/purplestone.xpm



EA ./textures/greystone.xpm


S          ./textures/linkpixel.xpm
F 255,0,0
C 0,255,0

111111111111111111111111111
1000002000000000000000000E1
100000000000000000000000001
100000001111111111111111111
101002001
100100021
100000001
100000001
100000101
120000011
111111111