R 1920 1080
NO ./textures/eagle.xpm
SO ./textures/red.xpm
WE ./textures/purplestone.xpm
EA ./textures/greystone.xpm
S ./textures/linkpixel.xpm
F 0,255,255
C 0,255,0

1111111111111111
1E00002000000001
1000000100000001
1110000000020011
1000100200000011
1111111111111111