F 125,5,55
C 25,47,0


R             1920         1080



NO      ./textures/eagle.xpm

WE ./textures/purplestone.xpm

SO            ./textures/red.xpm



EA ./textures/greystone.xpm
S ./textures/linkpixel.xpm


1111111111111111111111111111
10000000000000E0000000000021
1000  0000000000000000000001
1000000000011111111111111111
100000000001
100000200001
1000000000011111111111111111
1000000000000000000000000001
100000002000000000   0000000
1000000000000000000000000001
1111111111111111000000000001
               1000002000001
               1000000000001
1111111111111111000000200001
1000000000200000000000000001
1002000000000000000000000001
1111111111111111111111111111