R 1920 1080
NO ./textures/eagle.xpm
SO ./textures/red.xpm
WE ./textures/purplestone.xpm
EA ./textures/greystone.xpm
S ./textures/linkpixel.xpm
F 255,0,0
C 255,255,0

1111111111111111111111111111111111111111111111111
1N001000000100000000000101000000000 0000000000001
10000000000000000000020000001100002000 0000000001
1000100010000000      000000000000000000000000001
1111111111111111111000000000000111111111111111111
                  10000000200001
                  10000010000001
                  11001000001001
                  10000000000201
                  100000101 0001
                  10000000000001 
                  10000000000101
                  10000010000001
                  10200000000201
                  10000110000001
                  10000000000001
                  10   000000001
                  11111111111111