R 1920 1080
NO ./textures/eagle.xpm
SO ./textures/red.xpm
WE ./textures/purplestone.xpm
EA ./textures/greystone.xpm
S ./textures/linkpixel.xpm
F 125,5,55
C 25,47,0

1111111111        1111111111
1E       1        100000 001
1000000001        1000000001
1000000001        1000100001
1000000001        1001010001
1011 00001        1000000001
1000000001        1001000001
1000000001111111111000000001
1000100000000000022000000001
1000000002000002000000000001
10000  000000000010000001001
1111111111111111111111111111